TGCA,4999,2285,1500,4049,12833
CANNTG,4137,1946,1284,3385,10752
GTNNAC,2337,1202,684,2103,6326
ACGT,1880,1019,640,1690,5229
GNCAAY,1377,690,441,1277,3785
CNGTTR,1222,562,390,1072,3246
TGCAC,973,459,258,732,2422
AACTG,876,442,289,745,2352
GAAAAA,759,414,236,730,2139
TTGAC,752,393,221,697,2063
ACTGC,761,360,216,562,1899
RTTGMC,706,350,212,570,1838
CTTTTT,677,299,233,526,1735
WTTGGT,636,338,199,541,1714
YAACKG,621,314,192,557,1684
ACGTG,586,334,196,518,1634
WAACCA,580,281,177,487,1525
TGACG,487,233,148,429,1297
YGGCTG,401,201,109,350,1061
CATGTG,341,165,84,264,854
CACATG,347,153,82,246,828
RCCGAC,277,145,81,232,735
TGGCTG,260,123,79,225,687
ATTGAC,192,95,59,151,497
TTGACC,155,101,60,174,490
GTACAC,177,100,58,143,478
TAACTG,179,94,50,147,470
GTGTAC,175,83,50,151,459
AACTGG,164,75,56,146,441
ACCGAC,109,64,37,106,316
AWTTCAAA,104,40,27,95,266
TGCACMG,117,43,17,73,250
TGCASSSG,96,45,23,71,235
ACGTSSSC,79,30,24,59,192
TWAAGTTT,52,30,18,52,152
TCGGCGG,47,22,15,39,123
ACGTGKC,81,39,0,0,120
AACGTGT,33,24,8,35,100
AGCCGCC,57,31,0,0,88
TTGCACA,0,0,18,54,72
GATTGGT,0,0,16,49,65
CTAACCA,0,0,13,39,52
GGATGGNNNNNNNGA,26,18,0,0,44
YACGTGGC,25,9,0,0,34
KGTCCCAT,15,15,0,0,30
AGATCCAA,0,0,9,18,27
YCACTGNNNCG,17,8,0,0,25
RTGCACCG,14,10,0,0,24
CACGTGGC,17,6,0,0,23
RYACGTGGYR,17,6,0,0,23
ATCACCTA,0,0,5,12,17
MCAGGGTA,10,6,0,0,16
TCTAGGTT,13,3,0,0,16
ATGGCTGTA,2,0,0,0,2
