ACGTG,586,334,196,518,1634
TGCAC,973,459,258,732,2422
ACGT,1880,1019,640,1690,5229
TWAAGTTT,52,30,18,52,152
TTGCACA,0,0,18,54,72
CANNTG,4137,1946,1284,3385,10752
ATTGAC,192,95,59,151,497
CACGTGGC,17,6,0,0,23
KGTCCCAT,15,15,0,0,30
YACGTGGC,25,9,0,0,34
RTTGMC,706,350,212,570,1838
MCAGGGTA,10,6,0,0,16
TGCACMG,117,43,17,73,250
GTGTAC,175,83,50,151,459
WTTGGT,636,338,199,541,1714
TGGCTG,260,123,79,225,687
ATGGCTGTA,2,0,0,0,2
CACATG,347,153,82,246,828
GAAAAA,759,414,236,730,2139
TGCASSSG,96,45,23,71,235
ATCACCTA,0,0,5,12,17
YAACKG,621,314,192,557,1684
CATGTG,341,165,84,264,854
GATTGGT,0,0,16,49,65
AGATCCAA,0,0,9,18,27
TCTAGGTT,13,3,0,0,16
AWTTCAAA,104,40,27,95,266
YGGCTG,401,201,109,350,1061
CNGTTR,1222,562,390,1072,3246
AACTGG,164,75,56,146,441
ACCGAC,109,64,37,106,316
WAACCA,580,281,177,487,1525
TCGGCGG,47,22,15,39,123
CTAACCA,0,0,13,39,52
ACGTGKC,81,39,0,0,120
AACTG,876,442,289,745,2352
TAACTG,179,94,50,147,470
CTTTTT,677,299,233,526,1735
TGCA,4999,2285,1500,4049,12833
TTGACC,155,101,60,174,490
ACGTSSSC,79,30,24,59,192
RTGCACCG,14,10,0,0,24
RYACGTGGYR,17,6,0,0,23
AGCCGCC,57,31,0,0,88
GTNNAC,2337,1202,684,2103,6326
RCCGAC,277,145,81,232,735
GTACAC,177,100,58,143,478
TTGAC,752,393,221,697,2063
GNCAAY,1377,690,441,1277,3785
YCACTGNNNCG,17,8,0,0,25
ACTGC,761,360,216,562,1899
GGATGGNNNNNNNGA,26,18,0,0,44
AACGTGT,33,24,8,35,100
TGACG,487,233,148,429,1297
